2 8 5 7 3 6 1 9 4 
4 7 1 9 8 2 6 3 5 
6 3 9 5 4 1 8 2 7 
1 9 7 6 5 4 2 8 3 
8 5 6 3 2 9 4 7 1 
3 2 4 1 7 8 5 6 9 
5 4 8 2 9 7 3 1 6 
9 1 2 4 6 3 7 5 8 
7 6 3 8 1 5 9 4 2